#######################################
# Syntax Coloring Map for HomeNet
#######################################

#######################################
# Datatypes (KEYWORD1)
#######################################

HomeNet	KEYWORD1
HomeNetPacket	KEYWORD1
HomeNetDevice	KEYWORD1
HomeNetPayload	KEYWORD1
HomeNetSchedule	KEYWORD1
HomeNetInterrupt	KEYWORD1
HomeNetPort	KEYWORD1
HomeNetPortSerial	KEYWORD1
HomeNetPortRF12	KEYWORD1
HomeNetDeviceArduino	KEYWORD1
HomeNetDeviceJeeNode	KEYWORD1
HomeNetDeviceStatusLights	KEYWORD1
HomeNetDeviceLCD	KEYWORD1
HomeNetDeviceLCD::Display	KEYWORD1
HomeNetDeviceMotionSensor	KEYWORD1
HomeNetDeviceTMP37 	KEYWORD1
HomeNetDeviceLDR	KEYWORD1
HomeNetDeviceSwitch	KEYWORD1
HomeNetDeviceLED	KEYWORD1
HomeNetDeviceTMP421	KEYWORD1
HomeNetDeviceContactSwitch	KEYWORD1
HomeNetPartialPacket	KEYWORD1

#######################################
# Methods and Functions (KEYWORD2)
#######################################

init	KEYWORD2
receive	KEYWORD2
getNewPacket	KEYWORD2
clonePacket	KEYWORD2
process	KEYWORD2
processPacket	KEYWORD2
processCommand	KEYWORD2

addTcpPacket	KEYWORD2
addUdpPacket	KEYWORD2
addBroadcastPacket	KEYWORD2

debugPacket	KEYWORD2

registerStatusLights	KEYWORD2

registerSchedule	KEYWORD2
registerInterrupts	KEYWORD2
deviceUpdate	KEYWORD2
deviceSchedule	KEYWORD2
deviceInterrupt	KEYWORD2


#######################################
# Constants (LITERAL1)
#######################################

SEND_RECEIVE	LITERAL1

CMD_ERROR	LITERAL1
CMD_VERSION	LITERAL1
CMD_BATTERYLEVEL	LITERAL1
CMD_MEMORYFREE	LITERAL1
CMD_PING	LITERAL1
CMD_PONG	LITERAL1
CMD_ACK	LITERAL1
CMD_SETNODEID	LITERAL1
CMD_GETNODEID	LITERAL1
CMD_SETNODEID	LITERAL1
CMD_GETDEVICE	LITERAL1
CMD_SETDEVICE	LITERAL1
CMD_AUTOSENDSTART	LITERAL1
CMD_AUTOSENDSTOP	LITERAL1
CMD_GETVALUE	LITERAL1
CMD_SETVALUE	LITERAL1
CMD_ON	LITERAL1
CMD_OFF	LITERAL1
CMD_LEVEL	LITERAL1
CMD_CLEAR	LITERAL1
CMD_BYTE	LITERAL1
CMD_STRING	LITERAL1
CMD_INT	LITERAL1
CMD_FLOAT	LITERAL1
CMD_LONG	LITERAL1
CMD_MULTIPACKET	LITERAL1

PACKET_LENGTH	LITERAL1
PACKET_SETTINGS	LITERAL1
PACKET_FROM	LITERAL1
PACKET_TO	LITERAL1
PACKET_TTL	LITERAL1
PACKET_ID	LITERAL1
PACKET_COMMAND	LITERAL1
PACKET_PAYLOAD	LITERAL1

STATUS_CLEAR	LITERAL1
STATUS_RECEVING	LITERAL1
STATUS_RECEIVED	LITERAL1
STATUS_WAITING	LITERAL1
STATUS_READY	LITERAL1
STATUS_SENDING	LITERAL1
STATUS_SENT	LITERAL1
STATUS_ACK	LITERAL1

REDUCE_STACK	LITERAL1
STATUS_SUCCESS	LITERAL1
STATUS_FAILED	LITERAL1

OFFSET_PACKET	LITERAL1
OFFSET_HEADER	LITERAL1
OFFSET_FOOTER	LITERAL1

PORT_SERIAL0	LITERAL1
PORT_SERIAL	LITERAL1
PORT_SERIAL1	LITERAL1
PORT_SERIAL2	LITERAL1
PORT_SERIAL3	LITERAL1

PACKET_TCP	LITERAL1
PACKET_UDP	LITERAL1
PACKET_BROADCAST	LITERAL1
PACKET_BUFFER
PACKET_TIMEOUT	LITERAL1


